//MAP CONVERTED BY dmm2tgm.py THIS HEADER COMMENT PREVENTS RECONVERSION, DO NOT REMOVE
"a" = (
/obj/item/seeds/russ/mystery,
/turf/closed/mineral/random/snow,
/area/icemoon/surface/outdoors/nospawn)

(1,1,1) = {"
a
"}
