//MAP CONVERTED BY dmm2tgm.py THIS HEADER COMMENT PREVENTS RECONVERSION, DO NOT REMOVE
"a" = (
/obj/item/seeds/russ/mystery,
/obj/structure/closet/body_bag/bluespace,
/obj/item/flashlight/lantern/on,
/mob/living/basic/viscerator,
/mob/living/basic/viscerator,
/turf/open/misc/asteroid/snow/icemoon,
/area/icemoon/surface/outdoors/nospawn)

(1,1,1) = {"
a
"}
