//MAP CONVERTED BY dmm2tgm.py THIS HEADER COMMENT PREVENTS RECONVERSION, DO NOT REMOVE
"a" = (
/turf/template_noop,
/area/template_noop)
"b" = (
/obj/effect/turf_decal/tile/neutral/opposingcorners{
	dir = 1
	},
/turf/open/floor/mineral/titanium/blue,
/area/shuttle/supply)
"c" = (
/obj/machinery/power/shuttle_engine/propulsion/burst/left,
/turf/open/floor/plating/airless,
/area/shuttle/supply)
"d" = (
/turf/closed/wall/mineral/titanium,
/area/shuttle/supply)
"e" = (
/obj/effect/turf_decal/stripes/line{
	dir = 4
	},
/turf/open/floor/mineral/titanium/blue,
/area/shuttle/supply)
"f" = (
/obj/effect/turf_decal/stripes/corner{
	dir = 4
	},
/obj/effect/turf_decal/tile/dark/full,
/turf/open/floor/mineral/titanium/blue,
/area/shuttle/supply)
"i" = (
/obj/machinery/power/shuttle_engine/propulsion,
/turf/open/floor/plating/airless,
/area/shuttle/supply)
"j" = (
/obj/machinery/power/shuttle_engine/propulsion/burst/right,
/turf/open/floor/plating/airless,
/area/shuttle/supply)
"k" = (
/obj/machinery/door/poddoor{
	id = "QMLoaddoor";
	name = "Supply Dock Loading Door"
	},
/obj/machinery/conveyor{
	dir = 4;
	id = "CargoUnload"
	},
/turf/open/floor/plating,
/area/shuttle/supply)
"l" = (
/obj/effect/turf_decal/tile/neutral/anticorner{
	dir = 8
	},
/turf/open/floor/mineral/titanium/blue,
/area/shuttle/supply)
"n" = (
/obj/machinery/door/poddoor{
	id = "QMLoaddoor2";
	name = "Supply Dock Loading Door"
	},
/obj/machinery/conveyor{
	id = "CargoLoad";
	dir = 8
	},
/turf/open/floor/plating,
/area/shuttle/supply)
"o" = (
/obj/effect/turf_decal/tile/neutral{
	dir = 4
	},
/turf/open/floor/mineral/titanium/blue,
/area/shuttle/supply)
"p" = (
/obj/machinery/door/airlock/titanium{
	name = "Supply Shuttle Airlock"
	},
/obj/effect/mapping_helpers/airlock/access/all/supply/general,
/obj/docking_port/mobile/supply,
/turf/open/floor/plating,
/area/shuttle/supply)
"s" = (
/obj/effect/turf_decal/tile/neutral/anticorner,
/turf/open/floor/mineral/titanium/blue,
/area/shuttle/supply)
"v" = (
/obj/machinery/light/directional/north,
/obj/effect/turf_decal/tile/dark/full,
/turf/open/floor/mineral/titanium/blue,
/area/shuttle/supply)
"w" = (
/obj/structure/window/reinforced/spawner/directional/north,
/obj/machinery/power/shuttle_engine/heater,
/turf/open/floor/plating/airless,
/area/shuttle/supply)
"x" = (
/obj/machinery/light/directional/west,
/obj/effect/turf_decal/tile/neutral/opposingcorners,
/turf/open/floor/mineral/titanium/blue,
/area/shuttle/supply)
"z" = (
/obj/effect/turf_decal/stripes/corner,
/obj/effect/turf_decal/tile/dark/full,
/turf/open/floor/mineral/titanium/blue,
/area/shuttle/supply)
"A" = (
/obj/effect/turf_decal/tile/neutral/anticorner{
	dir = 4
	},
/turf/open/floor/mineral/titanium/blue,
/area/shuttle/supply)
"B" = (
/obj/effect/turf_decal/tile/neutral/anticorner{
	dir = 1
	},
/turf/open/floor/mineral/titanium/blue,
/area/shuttle/supply)
"C" = (
/obj/effect/turf_decal/stripes/line{
	dir = 4
	},
/obj/effect/turf_decal/tile/neutral{
	dir = 8
	},
/turf/open/floor/mineral/titanium/blue,
/area/shuttle/supply)
"E" = (
/obj/machinery/door/airlock/titanium{
	name = "Supply Shuttle Airlock"
	},
/obj/effect/mapping_helpers/airlock/access/all/supply/general,
/turf/open/floor/plating,
/area/shuttle/supply)
"F" = (
/obj/machinery/button/door/directional/east{
	id = "QMLoaddoor2";
	name = "Loading Doors";
	pixel_y = 8
	},
/obj/machinery/button/door/directional/east{
	id = "QMLoaddoor";
	name = "Loading Doors";
	pixel_y = -8
	},
/obj/machinery/light/directional/east,
/obj/effect/turf_decal/stripes/line{
	dir = 4
	},
/obj/effect/turf_decal/tile/neutral/opposingcorners,
/turf/open/floor/mineral/titanium/blue,
/area/shuttle/supply)
"J" = (
/obj/effect/turf_decal/tile/dark/full,
/turf/open/floor/mineral/titanium/blue,
/area/shuttle/supply)
"L" = (
/turf/closed/wall/mineral/titanium/interior,
/area/shuttle/supply)
"N" = (
/obj/effect/turf_decal/tile/dark/half{
	dir = 1
	},
/turf/open/floor/mineral/titanium/blue,
/area/shuttle/supply)
"P" = (
/obj/effect/turf_decal/tile/dark/half,
/turf/open/floor/mineral/titanium/blue,
/area/shuttle/supply)
"R" = (
/turf/closed/wall/mineral/titanium/nodiagonal,
/area/shuttle/supply)
"T" = (
/obj/effect/turf_decal/tile/neutral/full,
/turf/open/floor/mineral/titanium/blue,
/area/shuttle/supply)
"U" = (
/turf/open/floor/mineral/titanium/blue,
/area/shuttle/supply)
"V" = (
/obj/effect/turf_decal/stripes/line{
	dir = 4
	},
/obj/effect/turf_decal/tile/neutral{
	dir = 1
	},
/turf/open/floor/mineral/titanium/blue,
/area/shuttle/supply)
"W" = (
/obj/structure/sign/nanotrasen,
/turf/closed/wall/mineral/titanium,
/area/shuttle/supply)
"Y" = (
/obj/effect/turf_decal/tile/neutral,
/turf/open/floor/mineral/titanium/blue,
/area/shuttle/supply)

(1,1,1) = {"
a
L
d
d
d
W
d
d
d
d
L
a
"}
(2,1,1) = {"
L
R
J
Y
U
x
U
o
J
R
d
c
"}
(3,1,1) = {"
d
J
N
U
l
T
B
U
P
J
w
i
"}
(4,1,1) = {"
d
v
U
b
T
U
T
b
U
J
w
i
"}
(5,1,1) = {"
d
J
N
U
s
T
A
U
P
J
w
i
"}
(6,1,1) = {"
L
R
z
C
e
F
e
V
f
R
d
j
"}
(7,1,1) = {"
a
L
d
n
E
d
p
k
d
d
L
a
"}
